#########################################
#H                                      #
#                                       #
#                                       #
#                                       #
#                                       #
#                                       #
#                                       #
#                                       #
#                                       #
#                                       #
#                                       #
#                                       #
#                                      E#
#########################################
