#########
#H#     #
# # # #+#
# #+#   #
# # ###$#
#   #* E#
#########
