#########################################
#H                                      #
#                                       #
#                                       #
#                                       #
#                                       #
#                                       #
#                                       #
# #                                   # #
# #                                   # #
# #                                   # #
# #                                   # #
# ##################################### #
#                                      E#
#########################################
