#########################################
#H#                                     #
# # ################################### #
# # #                                   #
# # ################################### #
#                                     # #
# ################################### # #
#                                     # #
# ##################################### #
#                                     # #
# ################################### # #
#                                     # #
# ##################################### #
#                                      E#
#########################################
