#########################################
#H#                                     #
# # ################################### #
# # #                                   #
# # ################################### #
#                                     # #
# ################################### # #
#                                       #
##################################### # #
#                                     # #
# ################################### # #
# #                                   # #
# ##################################  # #
#                                      E#
#########################################
