#######
#     #
# H  *#
#  ++E#
#######
