10, 10, 1

90,90,90,90,90,90,90,90,90,65
90,90,90,90,90,90,90,90,90,65
90,90,90,65,65,65,65,65,65,65
90,90,65,65,65,65,65,65,65,65
90,90,65,65,65,65,65,65,65,65
90,90,65,65,65,65,65,65,65,65
90,90,65,65,65,65,65,65,65,65
90,90,90,90,65,65,65,65,65,65
90,90,90,90,90,90,90,90,90,65
90,90,90,90,90,90,90,90,90,65

00,00,00,00,00,00,00,00,00,13
00,00,00,00,00,00,00,00,00,23
00,00,00,00,00,00,00,00,00,00
00,00,00,00,00,00,00,00,00,00
00,00,00,00,00,00,00,00,00,00
00,00,13,00,00,00,13,00,00,00
00,00,23,00,00,00,23,00,00,00
00,00,00,00,00,00,00,00,00,00
00,00,00,00,00,00,00,00,00,13
00,00,00,00,00,00,00,00,00,23
