10, 10, 1

65,65,65,65,65,65,65,65,65,65
65,65,65,65,65,65,65,65,65,65
65,65,65,65,65,65,65,65,65,65
65,65,65,65,65,65,65,65,65,65
65,65,65,65,65,65,65,65,65,65
65,65,65,65,65,65,65,65,65,65
65,65,65,65,65,65,65,65,65,65
65,65,65,65,65,65,65,65,65,65
65,65,65,65,65,65,65,65,65,65
65,65,65,65,65,65,65,65,65,65

13,13,13,13,13,13,13,13,13,13
23,23,23,23,23,23,23,23,23,23
0,0,0,0,0,0,0,0,02,02
0,0,0,0,0,0,0,0,0,0
0,0,0,0,0,0,0,0,0,0
0,0,0,0,0,0,0,0,0,0
0,0,0,0,0,0,0,0,0,0
0,0,0,02,02,0,0,02,02,02
13,13,13,13,13,13,13,13,13,13
23,23,23,23,23,23,23,23,23,23
