10, 10, 1

65,65,65,65,65,65,65,65,65,65
65,65,65,65,65,65,65,65,65,65
65,65,65,65,65,65,65,65,53,53
65,65,65,65,65,65,65,65,65,65
65,65,65,65,65,65,65,65,53,53
65,65,65,65,65,65,65,65,65,65
65,65,65,65,65,65,65,65,53,53
65,65,65,65,65,65,65,65,65,65
65,65,65,65,65,65,65,65,53,53
65,65,65,65,65,65,65,65,65,65

13,13,13,13,13,13,13,13,13,13
23,23,23,23,23,23,23,23,23,23
0,0,0,0,0,0,0,0,0,0
0,0,0,0,0,0,0,0,0,0
0,0,0,0,0,0,0,0,0,0
0,0,0,0,0,0,0,0,0,0
0,0,0,0,0,0,0,0,0,0
0,0,0,0,0,0,0,0,0,0
13,13,13,13,13,13,13,13,13,13
23,23,23,23,23,23,23,23,23,23
