10, 10, 1

65,65,65,65,65,65,65,65,65,65
65,65,65,65,65,65,65,65,65,65
65,65,65,65,65,65,65,65,65,65
65,65,65,65,65,65,65,65,65,65
65,65,65,65,65,65,65,65,65,65
65,65,65,65,65,65,65,65,65,65
65,65,65,65,65,65,65,65,65,65
65,65,65,65,65,65,65,65,65,65
65,65,65,65,65,65,65,65,65,65
65,65,65,65,65,65,65,65,65,65

13,13,13,13,13,13,13,13,13,13
23,23,23,23,23,23,23,23,23,23
05,00,00,00,00,00,00,00,00,05
05,00,00,00,00,00,00,00,00,05
05,00,00,00,00,00,00,00,00,05
05,00,00,00,00,00,00,00,00,05
05,00,00,00,00,00,00,00,00,05
05,00,00,00,00,00,00,00,00,05
13,13,13,13,13,13,13,13,00,13
23,23,23,23,23,23,23,23,00,23
