10, 10, 1

65,65,65,65,65,65,65,65,65,65
65,65,65,65,65,65,65,65,65,65
65,65,65,65,65,65,65,65,65,65
65,65,65,65,65,65,65,65,65,65
65,65,65,65,65,65,65,65,65,65
65,65,65,65,65,65,65,65,65,65
65,65,65,65,65,65,65,65,65,65
65,65,65,65,65,65,65,65,65,65
65,65,65,65,65,65,65,65,65,65
65,65,65,65,65,65,65,65,65,65

05,05,05,05,00,00,05,05,05,05
05,00,00,00,00,00,00,00,00,05
05,00,00,00,00,00,00,00,00,05
05,00,00,00,00,00,00,00,00,05
05,00,00,00,00,00,00,00,00,00
05,00,00,00,00,00,00,00,00,00
05,00,00,00,00,00,00,00,00,05
05,00,00,00,00,00,00,00,00,05
05,00,00,00,00,00,00,00,00,05
05,05,05,05,05,05,05,05,05,05
